WWWWWWWWWWWWWWW    W
W                  W
W                  W
WWWWWWWWWWW      WWW
W                  W
W        W     WWWWW
W                  W
W                  W
WWWWWW       WWWWWWW
W                  W
W                  W
W   WWW       WWWWWW
W                  W
W                  W
WWWWWW    WWWWWWWWWW
