WWWWWWWWWWWWWWW    W
W   B              W
W                  W
WWWWWWWWWWW      WWW
W                  W
W  A     W     WWWWW
W                  W
W                  W
WWWWWW       WWWWWWW
W B             A  W
W                  W
W   WWW       WWWWWW
W A                W
W               A  W
WWWWWW    WWWWWWWWWW
