WWWWWW    WWWWWWWWWW
W                  W
W                  W
W        WWWW      W
W                  W
W                  W
W                  W
WWWW         WWWW  W
W                  W
W                  W
W       WWWWW      W
W                  W
W            WW    W
W                  W
WWWWWWWWWW    WWWWWW
