WWWWWWWWWWWWWWW    W
W                  W
W                  W
WWWWWWWWWWW      WWW
W                  W
W              WWWWW
W     WW           W
W                  W
WWWWWW      WWWWWWWW
W                  W
W                  W
W   WWW       WWWWWW
W                  W
W                  W
WWWWWW    WWWWWWWWWW
