WWWWWW    WWWWWWWWWW
W                  W
W                  W
W                  W
W      WW          W
W              WWWWW
W                  W
W        WWW       W
W                  W
W                  W
WWWWW     W   WWWWWW
W                  W
W                  W
W                  W
WWWWWW    WWWWWWWWWW
