WWWWWWWWWWWW    WWWW
W                  W
W B                W
W                  W
WWWWWWW      WWWWWWW
W                  W
W        A     B   W
W                  W
W      WWWWWW      W
W                  W
W                 WW
W                  W
W   A              W
W                  W
WWWWWWWWWWWWWWW    W
