WWWWWW    WWWWWWWWWW
W                  W
W  B               W
W                  W
W      WW          W
W              WWWWW
W               B  W
W        WWW       W
W                  W
W          A       W
WWWWW    W    WWWWWW
W                  W
W  A               W
W                  W
WWWWWW    WWWWWWWWWW
