WWWWWWWWWW    WWWWWW
W                  W
W                  W
W                  W
WWWWW              W
W                  W
W          WWWW    W
W                  W
W                  W
W                  W
W     WWWW         W
W                  W
W                  W
W                  W
WWWWWWWWWWWWWWWWWWWW
